######################################
##  ##          ##              ##  ##
##  ##  ##  ######  ##  ######  ##  ##
##      ##          ##      ##      ##
##  ######################  ##########
##  ##  ##              ##          ##
##  ##  ##  ######  ##############  ##
##  ##          ##              ##    
##  ##########  ######  ######  ######
##      ##          ##      ##      ##
######  ##  ##############  ##########
##  ##  ##      ##      ##          ##
##  ##  ######  ##  ##  ##########  ##
##  ##  ##      ##  ##          ##  ##
##  ##  ##  ######  ##########  ##  ##
##      ##      ##      ##  ##      ##
##  ##############  ##  ##  ######  ##
##              ##  ##  ##      ##  ##
##############  ######  ######  ##  ##
##      ##  ##      ##      ##  ##  ##
##  ##  ##  ######  ##  ##  ##  ##  ##
##  ##      ##      ##  ##  ##      ##
##  ######  ##  ######  ##  ######  ##
##      ##  ##      ##  ##      ##  ##
##  ##  ##########  ##########  ##  ##
##  ##          ##          ##  ##  ##
##  ##########  ##########  ##  ##  ##
##      ##      ##      ##      ##  ##
######  ##  ######  ##  ##########  ##
##      ##          ##              ##
##########  ##########################
