############################################################################
####                                                                    ####
####                                                                    ####
####                                                                    ####
####                                                                    ####
####################    ####################    ############################
####################    ####################    ############################
####################    ####################    ############################
####################    ####################    ############################
####            ####    ####                    ####                        
####            ####    ####                    ####                        
####            ####    ####                    ####                        
####            ####    ####                    ####                        
####    ####    ####    ####    ####################    ####################
####    ####    ####    ####    ####################    ####################
####    ####    ####    ####    ####################    ####################
####    ####    ####    ####    ####################    ####################
####    ####            ####                    ####                    ####
####    ####            ####                    ####                    ####
####    ####            ####                    ####                    ####
####    ####            ####                    ####                    ####
####    ############################################################    ####
####    ############################################################    ####
####    ############################################################    ####
####    ############################################################    ####
####    ####                                                    ####    ####
####    ####                                                    ####    ####
####    ####                                                    ####    ####
####    ####                                                    ####    ####
####    ####    ####################################    ############    ####
####    ####    ####################################    ############    ####
####    ####    ####################################    ############    ####
####    ####    ####################################    ############    ####
####    ####    ####                            ####    ####            ####
####    ####    ####                            ####    ####            ####
####    ####    ####                            ####    ####            ####
####    ####    ####                            ####    ####            ####
####    ####    ####    ####    ############    ####    ####    ############
####    ####    ####    ####    ############    ####    ####    ############
####    ####    ####    ####    ############    ####    ####    ############
####    ####    ####    ####    ############    ####    ####    ############
####            ####    ####            ####    ####            ####    ####
####            ####    ####            ####    ####            ####    ####
####            ####    ####            ####    ####            ####    ####
####            ####    ####            ####    ####            ####    ####
####    ############    ############    ############################    ####
####    ############    ############    ############################    ####
####    ############    ############    ############################    ####
####    ############    ############    ############################    ####
####    ####    ####    ####    ####                                    ####
####    ####    ####    ####    ####                                    ####
####    ####    ####    ####    ####                                    ####
####    ####    ####    ####    ####                                    ####
####    ####    ####    ####    ####################################    ####
####    ####    ####    ####    ####################################    ####
####    ####    ####    ####    ####################################    ####
####    ####    ####    ####    ####################################    ####
####    ####                                    ####                    ####
####    ####                                    ####                    ####
####    ####                                    ####                    ####
####    ####                                    ####                    ####
####    ############################################    ############    ####
####    ############################################    ############    ####
####    ############################################    ############    ####
####    ############################################    ############    ####
####    ####                                            ####    ####    ####
####    ####                                            ####    ####    ####
####    ####                                            ####    ####    ####
####    ####                                            ####    ####    ####
####    ####    ############################################    ####    ####
####    ####    ############################################    ####    ####
####    ####    ############################################    ####    ####
####    ####    ############################################    ####    ####
####    ####    ####            ####                            ####    ####
####    ####    ####            ####                            ####    ####
####    ####    ####            ####                            ####    ####
####    ####    ####            ####                            ####    ####
####    ####    ####    ####    ####    ####    ####################    ####
####    ####    ####    ####    ####    ####    ####################    ####
####    ####    ####    ####    ####    ####    ####################    ####
####    ####    ####    ####    ####    ####    ####################    ####
####            ####    ####    ####    ####                            ####
####            ####    ####    ####    ####                            ####
####            ####    ####    ####    ####                            ####
####            ####    ####    ####    ####                            ####
####################    ####    ####    ####################################
####################    ####    ####    ####################################
####################    ####    ####    ####################################
####################    ####    ####    ####################################
####    ####            ####            ####                            ####
####    ####            ####            ####                            ####
####    ####            ####            ####                            ####
####    ####            ####            ####                            ####
####    ####    ############################################    ####    ####
####    ####    ############################################    ####    ####
####    ####    ############################################    ####    ####
####    ####    ############################################    ####    ####
####            ####                    ####            ####    ####    ####
####            ####                    ####            ####    ####    ####
####            ####                    ####            ####    ####    ####
####            ####                    ####            ####    ####    ####
####    ####################    ####    ####    ####    ####    ####    ####
####    ####################    ####    ####    ####    ####    ####    ####
####    ####################    ####    ####    ####    ####    ####    ####
####    ####################    ####    ####    ####    ####    ####    ####
####            ####            ####            ####    ####    ####    ####
####            ####            ####            ####    ####    ####    ####
####            ####            ####            ####    ####    ####    ####
####            ####            ####            ####    ####    ####    ####
############    ####    ############################    ####    ####    ####
############    ####    ############################    ####    ####    ####
############    ####    ############################    ####    ####    ####
############    ####    ############################    ####    ####    ####
####                    ####                                    ####    ####
####                    ####                                    ####    ####
####                    ####                                    ####    ####
####                    ####                                    ####    ####
############################################    ############################
