##########################  ##########
##          ##          ##  ##      ##
######  ######  ##  ##  ##  ######  ##
##      ##      ##  ##  ##  ##      ##
##  ######  ######  ######  ##  ######
##  ##          ##  ##      ##      ##
##  ##  ##########  ##  ##########  ##
##  ##      ##      ##  ##      ##  ##
##  ##  ######  ######  ##  ##  ##  ##
##      ##      ##      ##  ##      ##
##########  ##  ##  ######  ##########
##          ##  ##  ##  ##          ##
##  ######  ######  ##  ##  ######  ##
##      ##  ##      ##          ##  ##
######  ##  ##  ##################  ##
##      ##  ##  ##      ##      ##  ##
##  ######  ##  ##  ##  ##  ##  ##  ##
##  ##      ##      ##  ##  ##      ##
##  ##  ##############  ##  ##########
##  ##          ##  ##  ##  ##      ##
##  ##########  ##  ##  ##  ##  ##  ##
##          ##      ##  ##      ##  ##
##  ######  ##########  ##  ######  ##
##      ##      ##      ##  ##      ##
##############  ##  ##########  ######
##              ##  ##      ##      ##
##  ##############  ##  ##  ######  ##
##  ##          ##  ##  ##          ##
##  ##  ######  ##  ##  ##########  ##
##          ##          ##          ##
##############################  ######
