###########################   ###########################
###               ###         ###               ###   ###
###               ###         ###               ###   ###
###               ###         ###               ###   ###
###   #########   ###   ###   ###   ###   ###   ###   ###
###   #########   ###   ###   ###   ###   ###   ###   ###
###   #########   ###   ###   ###   ###   ###   ###   ###
###   ###         ###   ###         ###   ###         ###
###   ###         ###   ###         ###   ###         ###
###   ###         ###   ###         ###   ###         ###
###   ###   #########   ###############   #########   ###
###   ###   #########   ###############   #########   ###
###   ###   #########   ###############   #########   ###
###   ###         ###               ###         ###   ###
###   ###         ###               ###         ###   ###
###   ###         ###               ###         ###   ###
###   #########   ###############   #########   ###   ###
###   #########   ###############   #########   ###   ###
###   #########   ###############   #########   ###   ###
###   ###   ###                     ###   ###   ###   ###
###   ###   ###                     ###   ###   ###   ###
###   ###   ###                     ###   ###   ###   ###
###   ###   ###########################   ###   #########
###   ###   ###########################   ###   #########
###   ###   ###########################   ###   #########
###   ###         ###               ###   ###         ###
###   ###         ###               ###   ###         ###
###   ###         ###               ###   ###         ###
###   ###   ###   ###   ###   ###   ###   #########   ###
###   ###   ###   ###   ###   ###   ###   #########   ###
###   ###   ###   ###   ###   ###   ###   #########   ###
###   ###   ###   ###   ###   ###         ###         ###
###   ###   ###   ###   ###   ###         ###         ###
###   ###   ###   ###   ###   ###         ###         ###
###   ###   ###   #########   ###############   ###   ###
###   ###   ###   #########   ###############   ###   ###
###   ###   ###   #########   ###############   ###   ###
###         ###   ###         ###         ###   ###   ###
###         ###   ###         ###         ###   ###   ###
###         ###   ###         ###         ###   ###   ###
###############   ###   #########   ###   ###   ###   ###
###############   ###   #########   ###   ###   ###   ###
###############   ###   #########   ###   ###   ###   ###
###         ###   ###   ###         ###         ###   ###
###         ###   ###   ###         ###         ###   ###
###         ###   ###   ###         ###         ###   ###
###   ###   ###   ###   ###   #####################   ###
###   ###   ###   ###   ###   #####################   ###
###   ###   ###   ###   ###   #####################   ###
###   ###   ###   ###   ###   ###         ###         ###
###   ###   ###   ###   ###   ###         ###         ###
###   ###   ###   ###   ###   ###         ###         ###
###   ###   ###   ###   ###   ###   ###   ###   #########
###   ###   ###   ###   ###   ###   ###   ###   #########
###   ###   ###   ###   ###   ###   ###   ###   #########
###   ###               ###   ###   ###         ###   ###
###   ###               ###   ###   ###         ###   ###
###   ###               ###   ###   ###         ###   ###
###   #####################   ###   ###############   ###
###   #####################   ###   ###############   ###
###   #####################   ###   ###############   ###
###   ###   ###               ###               ###   ###
###   ###   ###               ###               ###   ###
###   ###   ###               ###               ###   ###
###   ###   ###   ###   #####################   ###   ###
###   ###   ###   ###   #####################   ###   ###
###   ###   ###   ###   #####################   ###   ###
###   ###   ###   ###   ###         ###   ###         ###
###   ###   ###   ###   ###         ###   ###         ###
###   ###   ###   ###   ###         ###   ###         ###
###   ###   ###   #########   ###   ###   #########   ###
###   ###   ###   #########   ###   ###   #########   ###
###   ###   ###   #########   ###   ###   #########   ###
###         ###         ###   ###   ###               ###
###         ###         ###   ###   ###               ###
###         ###         ###   ###   ###               ###
#########   #########   ###   ###   #####################
#########   #########   ###   ###   #####################
#########   #########   ###   ###   #####################
###   ###         ###   ###   ###   ###                  
###   ###         ###   ###   ###   ###                  
###   ###         ###   ###   ###   ###                  
###   #########   ###   ###   ###   ###   ###############
###   #########   ###   ###   ###   ###   ###############
###   #########   ###   ###   ###   ###   ###############
###               ###         ###                     ###
###               ###         ###                     ###
###               ###         ###                     ###
#########################################################
