##############  ######################
##                                  ##
##  ##############################  ##
##              ##  ##              ##
##############  ##  ##  ##########  ##
##      ##          ##  ##      ##  ##
##  ##  ##########  ##  ##  ######  ##
##  ##          ##  ##  ##          ##
##  ##########  ######  ##  ##########
##      ##      ##      ##  ##      ##
##  ##  ##  ######  ######  ######  ##
##  ##  ##          ##  ##      ##  ##
##  ##  ##############  ######  ##  ##
##  ##          ##  ##      ##  ##  ##
##############  ##  ##  ##  ##  ##  ##
##              ##      ##          ##
##  ##################################
##  ##              ##              ##
##  ##  ##########  ##  ##########  ##
##      ##  ##      ##          ##  ##
##  ######  ##  ##############  ##  ##
##          ##  ##          ##  ##  ##
##########  ##  ##  ##  ######  ##  ##
##      ##  ##      ##      ##  ##  ##
##  ##  ##  ##############  ##  ##  ##
##  ##  ##  ##          ##      ##    
######  ##  ##  ######  ##############
##      ##      ##  ##  ##          ##
##  ##############  ##  ##########  ##
##                                  ##
######################################
