###   ###################################################
###                     ###                           ###
###                     ###                           ###
###                     ###                           ###
###   #########   #########   ###############   ###   ###
###   #########   #########   ###############   ###   ###
###   #########   #########   ###############   ###   ###
###   ###         ###         ###         ###   ###   ###
###   ###         ###         ###         ###   ###   ###
###   ###         ###         ###         ###   ###   ###
#########   ###   ###   #########   ###   ###   ###   ###
#########   ###   ###   #########   ###   ###   ###   ###
#########   ###   ###   #########   ###   ###   ###   ###
###         ###   ###         ###   ###         ###   ###
###         ###   ###         ###   ###         ###   ###
###         ###   ###         ###   ###         ###   ###
###   #####################   ###   ###############   ###
###   #####################   ###   ###############   ###
###   #####################   ###   ###############   ###
###   ###                     ###   ###               ###
###   ###                     ###   ###               ###
###   ###                     ###   ###               ###
###   ###   #####################   #########   #########
###   ###   #####################   #########   #########
###   ###   #####################   #########   #########
###   ###         ###         ###         ###         ###
###   ###         ###         ###         ###         ###
###   ###         ###         ###         ###         ###
###   #########   ###   ###   ###   ###   ###############
###   #########   ###   ###   ###   ###   ###############
###   #########   ###   ###   ###   ###   ###############
###               ###   ###   ###   ###               ###
###               ###   ###   ###   ###               ###
###               ###   ###   ###   ###               ###
###   ###############   ###   ###   ###############   ###
###   ###############   ###   ###   ###############   ###
###   ###############   ###   ###   ###############   ###
###   ###         ###   ###   ###         ###         ###
###   ###         ###   ###   ###         ###         ###
###   ###         ###   ###   ###         ###         ###
###   #########   ###   ###   #########   ###   ###   ###
###   #########   ###   ###   #########   ###   ###   ###
###   #########   ###   ###   #########   ###   ###   ###
###   ###         ###   ###   ###         ###   ###   ###
###   ###         ###   ###   ###         ###   ###   ###
###   ###         ###   ###   ###         ###   ###   ###
###   ###   ###   ###   ###   ###############   ###   ###
###   ###   ###   ###   ###   ###############   ###   ###
###   ###   ###   ###   ###   ###############   ###   ###
###         ###   ###   ###                     ###   ###
###         ###   ###   ###                     ###   ###
###         ###   ###   ###                     ###   ###
###############   ###   ###########################   ###
###############   ###   ###########################   ###
###############   ###   ###########################   ###
###         ###   ###         ###                     ###
###         ###   ###         ###                     ###
###         ###   ###         ###                     ###
###   ###   ###############   ###   #####################
###   ###   ###############   ###   #####################
###   ###   ###############   ###   #####################
###   ###   ###               ###   ###               ###
###   ###   ###               ###   ###               ###
###   ###   ###               ###   ###               ###
###   ###   ###   ###############   ###############   ###
###   ###   ###   ###############   ###############   ###
###   ###   ###   ###############   ###############   ###
###   ###         ###         ###               ###   ###
###   ###         ###         ###               ###   ###
###   ###         ###         ###               ###   ###
###   ###############   ###   ###############   ###   ###
###   ###############   ###   ###############   ###   ###
###   ###############   ###   ###############   ###   ###
      ###               ###   ###               ###   ###
      ###               ###   ###               ###   ###
      ###               ###   ###               ###   ###
#########   ###############   ###   ###############   ###
#########   ###############   ###   ###############   ###
#########   ###############   ###   ###############   ###
###   ###   ###         ###         ###               ###
###   ###   ###         ###         ###               ###
###   ###   ###         ###         ###               ###
###   ###   ###   ###   ###########################   ###
###   ###   ###   ###   ###########################   ###
###   ###   ###   ###   ###########################   ###
###               ###                                 ###
###               ###                                 ###
###               ###                                 ###
#########################################################
