#########################################################
###                                       ###         ###
###                                       ###         ###
###                                       ###         ###
###   ###########################   #########   ###   ###
###   ###########################   #########   ###   ###
###   ###########################   #########   ###   ###
###   ###         ###         ###   ###         ###      
###   ###         ###         ###   ###         ###      
###   ###         ###         ###   ###         ###      
###   #########   ###   ###   ###   ###   ###############
###   #########   ###   ###   ###   ###   ###############
###   #########   ###   ###   ###   ###   ###############
###         ###         ###   ###         ###         ###
###         ###         ###   ###         ###         ###
###         ###         ###   ###         ###         ###
#########   ###   #########   #####################   ###
#########   ###   #########   #####################   ###
#########   ###   #########   #####################   ###
###         ###         ###                     ###   ###
###         ###         ###                     ###   ###
###         ###         ###                     ###   ###
###   #####################   #########   ###   ###   ###
###   #####################   #########   ###   ###   ###
###   #####################   #########   ###   ###   ###
###   ###               ###   ###         ###         ###
###   ###               ###   ###         ###         ###
###   ###               ###   ###         ###         ###
###   ###   #########   #########   ###############   ###
###   ###   #########   #########   ###############   ###
###   ###   #########   #########   ###############   ###
###   ###   ###   ###   ###         ###         ###   ###
###   ###   ###   ###   ###         ###         ###   ###
###   ###   ###   ###   ###         ###         ###   ###
###   ###   ###   ###   ###   #########   ###   ###   ###
###   ###   ###   ###   ###   #########   ###   ###   ###
###   ###   ###   ###   ###   #########   ###   ###   ###
###         ###   ###   ###         ###   ###   ###   ###
###         ###   ###   ###         ###   ###   ###   ###
###         ###   ###   ###         ###   ###   ###   ###
###############   ###   ###   ###   ###   #########   ###
###############   ###   ###   ###   ###   #########   ###
###############   ###   ###   ###   ###   #########   ###
###   ###         ###   ###   ###   ###               ###
###   ###         ###   ###   ###   ###               ###
###   ###         ###   ###   ###   ###               ###
###   ###   ###   ###   ###   ###   #####################
###   ###   ###   ###   ###   ###   #####################
###   ###   ###   ###   ###   ###   #####################
###         ###   ###   ###   ###         ###         ###
###         ###   ###   ###   ###         ###         ###
###         ###   ###   ###   ###         ###         ###
###   #########   ###   ###############   ###   ###   ###
###   #########   ###   ###############   ###   ###   ###
###   #########   ###   ###############   ###   ###   ###
###   ###         ###               ###         ###   ###
###   ###         ###               ###         ###   ###
###   ###         ###               ###         ###   ###
###   ###   #####################   ###   #########   ###
###   ###   #####################   ###   #########   ###
###   ###   #####################   ###   #########   ###
###   ###                     ###   ###         ###   ###
###   ###                     ###   ###         ###   ###
###   ###                     ###   ###         ###   ###
###   ###############   ###   ###   ###############   ###
###   ###############   ###   ###   ###############   ###
###   ###############   ###   ###   ###############   ###
###   ###               ###   ###               ###   ###
###   ###               ###   ###               ###   ###
###   ###               ###   ###               ###   ###
#########   ###############   ###############   ###   ###
#########   ###############   ###############   ###   ###
#########   ###############   ###############   ###   ###
###         ###                     ###         ###   ###
###         ###                     ###         ###   ###
###         ###                     ###         ###   ###
###   #########   ###############   ###   #########   ###
###   #########   ###############   ###   #########   ###
###   #########   ###############   ###   #########   ###
###         ###   ###         ###   ###               ###
###         ###   ###         ###   ###               ###
###         ###   ###         ###   ###               ###
###   ###   #########   ###   #####################   ###
###   ###   #########   ###   #####################   ###
###   ###   #########   ###   #####################   ###
###   ###               ###                           ###
###   ###               ###                           ###
###   ###               ###                           ###
#####################   #################################
