##################  ##################
##      ##                  ##      ##
##  ##  ##  ##############  ######  ##
##  ##      ##  ##      ##          ##
##  ##########  ##  ##  ##########  ##
##  ##              ##  ##      ##  ##
##  ##  ##############  ##  ##  ##  ##
##  ##              ##  ##  ##  ##  ##
##  ##################  ##  ##  ##  ##
##      ##          ##      ##      ##
##  ##  ##  ######  ##############  ##
##  ##          ##              ##  ##
##  ##################  ######  ##  ##
##  ##              ##  ##  ##  ##  ##
######  ##########  ##  ##  ##  ##  ##
##      ##          ##      ##  ##  ##
##  ######  ##################  ##  ##
    ##      ##                  ##  ##
######  ######  ######  ##########  ##
##  ##  ##          ##  ##      ##  ##
##  ##  ##  ##########  ##  ######  ##
##      ##  ##  ##      ##      ##  ##
##  ######  ##  ##  ######  ##  ##  ##
##  ##          ##  ##      ##      ##
##  ##############  ##  ##############
##                  ##          ##  ##
##############################  ##  ##
##          ##      ##      ##  ##  ##
##  ##  ######  ##  ##  ##  ##  ##  ##
##  ##          ##      ##          ##
######################################
