############################################################################
####                            ####                                    ####
####                            ####                                    ####
####                            ####                                    ####
####                            ####                                    ####
####    ####    ####    ############    ####    ####################    ####
####    ####    ####    ############    ####    ####################    ####
####    ####    ####    ############    ####    ####################    ####
####    ####    ####    ############    ####    ####################    ####
####    ####    ####    ####            ####    ####                    ####
####    ####    ####    ####            ####    ####                    ####
####    ####    ####    ####            ####    ####                    ####
####    ####    ####    ####            ####    ####                    ####
############    ####    ####    ############    ####################    ####
############    ####    ####    ############    ####################    ####
############    ####    ####    ############    ####################    ####
############    ####    ####    ############    ####################    ####
####            ####    ####            ####    ####            ####    ####
####            ####    ####            ####    ####            ####    ####
####            ####    ####            ####    ####            ####    ####
####            ####    ####            ####    ####            ####    ####
####    ############################    ####    ####    ####    ####    ####
####    ############################    ####    ####    ####    ####    ####
####    ############################    ####    ####    ####    ####    ####
####    ############################    ####    ####    ####    ####    ####
####                            ####    ####            ####    ####    ####
####                            ####    ####            ####    ####    ####
####                            ####    ####            ####    ####    ####
####                            ####    ####            ####    ####    ####
####    ############    ####    ####    ####################    ####    ####
####    ############    ####    ####    ####################    ####    ####
####    ############    ####    ####    ####################    ####    ####
####    ############    ####    ####    ####################    ####    ####
####    ####            ####    ####                    ####    ####    ####
####    ####            ####    ####                    ####    ####    ####
####    ####            ####    ####                    ####    ####    ####
####    ####            ####    ####                    ####    ####    ####
############    ############    ############    ############    ####    ####
############    ############    ############    ############    ####    ####
############    ############    ############    ############    ####    ####
############    ############    ############    ############    ####    ####
####            ####                    ####    ####            ####    ####
####            ####                    ####    ####            ####    ####
####            ####                    ####    ####            ####    ####
####            ####                    ####    ####            ####    ####
####    ####################################    ####    ####################
####    ####################################    ####    ####################
####    ####################################    ####    ####################
####    ####################################    ####    ####################
####    ####                                    ####                    ####
####    ####                                    ####                    ####
####    ####                                    ####                    ####
####    ####                                    ####                    ####
####    ####    ####################################################    ####
####    ####    ####################################################    ####
####    ####    ####################################################    ####
####    ####    ####################################################    ####
####    ####                                    ####                        
####    ####                                    ####                        
####    ####                                    ####                        
####    ####                                    ####                        
####    ####    ####################    ############    ############    ####
####    ####    ####################    ############    ############    ####
####    ####    ####################    ############    ############    ####
####    ####    ####################    ############    ############    ####
####            ####            ####    ####            ####            ####
####            ####            ####    ####            ####            ####
####            ####            ####    ####            ####            ####
####            ####            ####    ####            ####            ####
####    ############    ####    ############    ############    ############
####    ############    ####    ############    ############    ############
####    ############    ####    ############    ############    ############
####    ############    ####    ############    ############    ############
####            ####    ####            ####            ####            ####
####            ####    ####            ####            ####            ####
####            ####    ####            ####            ####            ####
####            ####    ####            ####            ####            ####
############    ####    ############    ####    ####    ####################
############    ####    ############    ####    ####    ####################
############    ####    ############    ####    ####    ####################
############    ####    ############    ####    ####    ####################
####            ####            ####    ####    ####                    ####
####            ####            ####    ####    ####                    ####
####            ####            ####    ####    ####                    ####
####            ####            ####    ####    ####                    ####
############################    ####    ############################    ####
############################    ####    ############################    ####
############################    ####    ############################    ####
############################    ####    ############################    ####
####                            ####                                    ####
####                            ####                                    ####
####                            ####                                    ####
####                            ####                                    ####
####    ############################################################    ####
####    ############################################################    ####
####    ############################################################    ####
####    ############################################################    ####
####                    ####            ####            ####            ####
####                    ####            ####            ####            ####
####                    ####            ####            ####            ####
####                    ####            ####            ####            ####
####    ############    ####    ####    ####    ####    ############    ####
####    ############    ####    ####    ####    ####    ############    ####
####    ############    ####    ####    ####    ####    ############    ####
####    ############    ####    ####    ####    ####    ############    ####
####            ####            ####            ####            ####    ####
####            ####            ####            ####            ####    ####
####            ####            ####            ####            ####    ####
####            ####            ####            ####            ####    ####
############    ############################################    ####    ####
############    ############################################    ####    ####
############    ############################################    ####    ####
############    ############################################    ####    ####
####                            ####                            ####    ####
####                            ####                            ####    ####
####                            ####                            ####    ####
####                            ####                            ####    ####
####################################    ####################################
