############################################################################
####    ####                                                    ####    ####
####    ####                                                    ####    ####
####    ####                                                    ####    ####
####    ####                                                    ####    ####
####    ####    ####    ####################################    ####    ####
####    ####    ####    ####################################    ####    ####
####    ####    ####    ####################################    ####    ####
####    ####    ####    ####################################    ####    ####
####            ####                    ####    ####            ####    ####
####            ####                    ####    ####            ####    ####
####            ####                    ####    ####            ####    ####
####            ####                    ####    ####            ####    ####
####    ############################    ####    ####    ############    ####
####    ############################    ####    ####    ############    ####
####    ############################    ####    ####    ############    ####
####    ############################    ####    ####    ############    ####
####    ####            ####            ####    ####    ####            ####
####    ####            ####            ####    ####    ####            ####
####    ####            ####            ####    ####    ####            ####
####    ####            ####            ####    ####    ####            ####
####    ####    ####    ####    ############    ####    ####    ####    ####
####    ####    ####    ####    ############    ####    ####    ####    ####
####    ####    ####    ####    ############    ####    ####    ####    ####
####    ####    ####    ####    ############    ####    ####    ####    ####
####    ####    ####            ####    ####            ####    ####    ####
####    ####    ####            ####    ####            ####    ####    ####
####    ####    ####            ####    ####            ####    ####    ####
####    ####    ####            ####    ####            ####    ####    ####
####    ####    ####################    ####    ############    ############
####    ####    ####################    ####    ############    ############
####    ####    ####################    ####    ############    ############
####    ####    ####################    ####    ############    ############
####    ####                    ####            ####                    ####
####    ####                    ####            ####                    ####
####    ####                    ####            ####                    ####
####    ####                    ####            ####                    ####
####    ####################    ####    ############    ############    ####
####    ####################    ####    ############    ############    ####
####    ####################    ####    ############    ############    ####
####    ####################    ####    ############    ############    ####
####    ####            ####    ####    ####    ####    ####            ####
####    ####            ####    ####    ####    ####    ####            ####
####    ####            ####    ####    ####    ####    ####            ####
####    ####            ####    ####    ####    ####    ####            ####
####    ####    ####    ####    ####    ####    ####    ####    ############
####    ####    ####    ####    ####    ####    ####    ####    ############
####    ####    ####    ####    ####    ####    ####    ####    ############
####    ####    ####    ####    ####    ####    ####    ####    ############
####            ####    ####    ####    ####            ####            ####
####            ####    ####    ####    ####            ####            ####
####            ####    ####    ####    ####            ####            ####
####            ####    ####    ####    ####            ####            ####
############    ############    ####    ############################    ####
############    ############    ####    ############################    ####
############    ############    ####    ############################    ####
############    ############    ####    ############################    ####
                ####            ####                                    ####
                ####            ####                                    ####
                ####            ####                                    ####
                ####            ####                                    ####
####    ############    ############################################    ####
####    ############    ############################################    ####
####    ############    ############################################    ####
####    ############    ############################################    ####
####    ####            ####    ####                    ####            ####
####    ####            ####    ####                    ####            ####
####    ####            ####    ####                    ####            ####
####    ####            ####    ####                    ####            ####
####    ####    ############    ####    ############    ####    ############
####    ####    ############    ####    ############    ####    ############
####    ####    ############    ####    ############    ####    ############
####    ####    ############    ####    ############    ####    ############
####    ####            ####    ####    ####    ####            ####    ####
####    ####            ####    ####    ####    ####            ####    ####
####    ####            ####    ####    ####    ####            ####    ####
####    ####            ####    ####    ####    ####            ####    ####
####    ############    ####    ####    ####    ####################    ####
####    ############    ####    ####    ####    ####################    ####
####    ############    ####    ####    ####    ####################    ####
####    ############    ####    ####    ####    ####################    ####
####    ####    ####    ####    ####    ####                            ####
####    ####    ####    ####    ####    ####                            ####
####    ####    ####    ####    ####    ####                            ####
####    ####    ####    ####    ####    ####                            ####
####    ####    ####    ####    ####    ####    ####################    ####
####    ####    ####    ####    ####    ####    ####################    ####
####    ####    ####    ####    ####    ####    ####################    ####
####    ####    ####    ####    ####    ####    ####################    ####
####    ####    ####    ####                    ####            ####    ####
####    ####    ####    ####                    ####            ####    ####
####    ####    ####    ####                    ####            ####    ####
####    ####    ####    ####                    ####            ####    ####
####    ####    ####    ############################    ############    ####
####    ####    ####    ############################    ############    ####
####    ####    ####    ############################    ############    ####
####    ####    ####    ############################    ############    ####
####    ####    ####                    ####    ####            ####    ####
####    ####    ####                    ####    ####            ####    ####
####    ####    ####                    ####    ####            ####    ####
####    ####    ####                    ####    ####            ####    ####
####    ####    ####################    ####    ####    ####    ####    ####
####    ####    ####################    ####    ####    ####    ####    ####
####    ####    ####################    ####    ####    ####    ####    ####
####    ####    ####################    ####    ####    ####    ####    ####
####            ####            ####    ####    ####    ####    ####    ####
####            ####            ####    ####    ####    ####    ####    ####
####            ####            ####    ####    ####    ####    ####    ####
####            ####            ####    ####    ####    ####    ####    ####
############    ####    ############    ####    ####    ####    ####    ####
############    ####    ############    ####    ####    ####    ####    ####
############    ####    ############    ####    ####    ####    ####    ####
############    ####    ############    ####    ####    ####    ####    ####
####                    ####            ####            ####            ####
####                    ####            ####            ####            ####
####                    ####            ####            ####            ####
####                    ####            ####            ####            ####
############################    ############################################
