############################################################################
####                                    ####            ####            ####
####                                    ####            ####            ####
####                                    ####            ####            ####
####                                    ####            ####            ####
####    ############    ############    ####    ####    ####    ####    ####
####    ############    ############    ####    ####    ####    ####    ####
####    ############    ############    ####    ####    ####    ####    ####
####    ############    ############    ####    ####    ####    ####    ####
####            ####    ####    ####            ####            ####    ####
####            ####    ####    ####            ####            ####    ####
####            ####    ####    ####            ####            ####    ####
####            ####    ####    ####            ####            ####    ####
############    ####    ####    ####################################    ####
############    ####    ####    ####################################    ####
############    ####    ####    ####################################    ####
############    ####    ####    ####################################    ####
####    ####    ####    ####            ####                            ####
####    ####    ####    ####            ####                            ####
####    ####    ####    ####            ####                            ####
####    ####    ####    ####            ####                            ####
####    ####    ####    ####    ####    ####    ############################
####    ####    ####    ####    ####    ####    ############################
####    ####    ####    ####    ####    ####    ############################
####    ####    ####    ####    ####    ####    ############################
####    ####    ####    ####    ####    ####    ####                    ####
####    ####    ####    ####    ####    ####    ####                    ####
####    ####    ####    ####    ####    ####    ####                    ####
####    ####    ####    ####    ####    ####    ####                    ####
####    ####    ####    ####    ############    ####################    ####
####    ####    ####    ####    ############    ####################    ####
####    ####    ####    ####    ############    ####################    ####
####    ####    ####    ####    ############    ####################    ####
####            ####    ####            ####                            ####
####            ####    ####            ####                            ####
####            ####    ####            ####                            ####
####            ####    ####            ####                            ####
####################    ####    ####    ####    ############################
####################    ####    ####    ####    ############################
####################    ####    ####    ####    ############################
####################    ####    ####    ####    ############################
####                    ####    ####            ####                    ####
####                    ####    ####            ####                    ####
####                    ####    ####            ####                    ####
####                    ####    ####            ####                    ####
####    ####################    ####################    ############    ####
####    ####################    ####################    ############    ####
####    ####################    ####################    ############    ####
####    ####################    ####################    ############    ####
####            ####            ####            ####    ####    ####    ####
####            ####            ####            ####    ####    ####    ####
####            ####            ####            ####    ####    ####    ####
####            ####            ####            ####    ####    ####    ####
####    ####    ############    ####    ####    ####    ####    ####    ####
####    ####    ############    ####    ####    ####    ####    ####    ####
####    ####    ############    ####    ####    ####    ####    ####    ####
####    ####    ############    ####    ####    ####    ####    ####    ####
####    ####            ####            ####    ####            ####        
####    ####            ####            ####    ####            ####        
####    ####            ####            ####    ####            ####        
####    ####            ####            ####    ####            ####        
####    ############    ####################    ############    ############
####    ############    ####################    ############    ############
####    ############    ####################    ############    ############
####    ############    ####################    ############    ############
####    ####    ####    ####                    ####            ####    ####
####    ####    ####    ####                    ####            ####    ####
####    ####    ####    ####                    ####            ####    ####
####    ####    ####    ####                    ####            ####    ####
####    ####    ####    ############################    ############    ####
####    ####    ####    ############################    ############    ####
####    ####    ####    ############################    ############    ####
####    ####    ####    ############################    ############    ####
####    ####    ####    ####                    ####            ####    ####
####    ####    ####    ####                    ####            ####    ####
####    ####    ####    ####                    ####            ####    ####
####    ####    ####    ####                    ####            ####    ####
####    ####    ####    ####    ############    ############    ####    ####
####    ####    ####    ####    ############    ############    ####    ####
####    ####    ####    ####    ############    ############    ####    ####
####    ####    ####    ####    ############    ############    ####    ####
####            ####    ####    ####    ####                    ####    ####
####            ####    ####    ####    ####                    ####    ####
####            ####    ####    ####    ####                    ####    ####
####            ####    ####    ####    ####                    ####    ####
############    ####    ####    ####    ############################    ####
############    ####    ####    ####    ############################    ####
############    ####    ####    ####    ############################    ####
############    ####    ####    ####    ############################    ####
####    ####    ####            ####                            ####    ####
####    ####    ####            ####                            ####    ####
####    ####    ####            ####                            ####    ####
####    ####    ####            ####                            ####    ####
####    ####    ############################    ####    ####    ####    ####
####    ####    ############################    ####    ####    ####    ####
####    ####    ############################    ####    ####    ####    ####
####    ####    ############################    ####    ####    ####    ####
        ####    ####                    ####    ####    ####            ####
        ####    ####                    ####    ####    ####            ####
        ####    ####                    ####    ####    ####            ####
        ####    ####                    ####    ####    ####            ####
####    ####    ####    ############    ############    ############    ####
####    ####    ####    ############    ############    ############    ####
####    ####    ####    ############    ############    ############    ####
####    ####    ####    ############    ############    ############    ####
####    ####    ####            ####    ####            ####    ####    ####
####    ####    ####            ####    ####            ####    ####    ####
####    ####    ####            ####    ####            ####    ####    ####
####    ####    ####            ####    ####            ####    ####    ####
####    ####    ############    ####    ####    ############    ####    ####
####    ####    ############    ####    ####    ############    ####    ####
####    ####    ############    ####    ####    ############    ####    ####
####    ####    ############    ####    ####    ############    ####    ####
####                            ####            ####                    ####
####                            ####            ####                    ####
####                            ####            ####                    ####
####                            ####            ####                    ####
############################################################################
