###   ###################################################
###         ###         ###               ###         ###
###         ###         ###               ###         ###
###         ###         ###               ###         ###
#########   ###   ###   #########   ###   ###   ###   ###
#########   ###   ###   #########   ###   ###   ###   ###
#########   ###   ###   #########   ###   ###   ###   ###
###   ###         ###   ###         ###         ###   ###
###   ###         ###   ###         ###         ###   ###
###   ###         ###   ###         ###         ###   ###
###   ###############   ###   #####################   ###
###   ###############   ###   #####################   ###
###   ###############   ###   #####################   ###
###               ###   ###   ###               ###   ###
###               ###   ###   ###               ###   ###
###               ###   ###   ###               ###   ###
###   ###   ###   ###   ###   #########   ###   ###   ###
###   ###   ###   ###   ###   #########   ###   ###   ###
###   ###   ###   ###   ###   #########   ###   ###   ###
###   ###   ###   ###   ###         ###   ###         ###
###   ###   ###   ###   ###         ###   ###         ###
###   ###   ###   ###   ###         ###   ###         ###
###   ###   #########   ###   ###   ###############   ###
###   ###   #########   ###   ###   ###############   ###
###   ###   #########   ###   ###   ###############   ###
###   ###               ###   ###               ###   ###
###   ###               ###   ###               ###   ###
###   ###               ###   ###               ###   ###
###   #####################   ###############   #########
###   #####################   ###############   #########
###   #####################   ###############   #########
###         ###         ###               ###         ###
###         ###         ###               ###         ###
###         ###         ###               ###         ###
#########   ###   ###   ###############   #########   ###
#########   ###   ###   ###############   #########   ###
#########   ###   ###   ###############   #########   ###
###   ###   ###   ###   ###               ###         ###
###   ###   ###   ###   ###               ###         ###
###   ###   ###   ###   ###               ###         ###
###   ###   ###   ###   ###############   ###   ###   ###
###   ###   ###   ###   ###############   ###   ###   ###
###   ###   ###   ###   ###############   ###   ###   ###
###   ###   ###   ###   ###         ###   ###   ###   ###
###   ###   ###   ###   ###         ###   ###   ###   ###
###   ###   ###   ###   ###         ###   ###   ###   ###
###   ###   ###   ###   ###   ###   #########   ###   ###
###   ###   ###   ###   ###   ###   #########   ###   ###
###   ###   ###   ###   ###   ###   #########   ###   ###
###   ###         ###   ###   ###               ###   ###
###   ###         ###   ###   ###               ###   ###
###   ###         ###   ###   ###               ###   ###
###   ###############   ###   #####################   ###
###   ###############   ###   #####################   ###
###   ###############   ###   #####################   ###
###         ###         ###         ###         ###   ###
###         ###         ###         ###         ###   ###
###         ###         ###         ###         ###   ###
###   ###   ###   #########   ###   ###   #########   ###
###   ###   ###   #########   ###   ###   #########   ###
###   ###   ###   #########   ###   ###   #########   ###
###   ###   ###   ###         ###   ###               ###
###   ###   ###   ###         ###   ###               ###
###   ###   ###   ###         ###   ###               ###
###   ###   ###   ###############   ###   ###############
###   ###   ###   ###############   ###   ###############
###   ###   ###   ###############   ###   ###############
###   ###   ###   ###         ###   ###         ###   ###
###   ###   ###   ###         ###   ###         ###   ###
###   ###   ###   ###         ###   ###         ###   ###
###   ###   ###   ###   ###   ###   #########   ###   ###
###   ###   ###   ###   ###   ###   #########   ###   ###
###   ###   ###   ###   ###   ###   #########   ###   ###
###   ###   ###         ###   ###         ###         ###
###   ###   ###         ###   ###         ###         ###
###   ###   ###         ###   ###         ###         ###
#########   ###############   #########   #########   ###
#########   ###############   #########   #########   ###
#########   ###############   #########   #########   ###
###                     ###               ###   ###   ###
###                     ###               ###   ###   ###
###                     ###               ###   ###   ###
###   #######################################   ###   ###
###   #######################################   ###   ###
###   #######################################   ###   ###
###                                                   ###
###                                                   ###
###                                                   ###
#########   #############################################
