##############  ######################
##              ##  ##              ##
##  ##########  ##  ##  ######  ##  ##
##          ##      ##  ##      ##  ##
##  ######  ######  ##  ##  ######  ##
##  ##  ##      ##  ##  ##  ##      ##
##  ##  ######  ######  ##  ##  ######
##      ##  ##          ##  ##      ##
######  ##  ##############  ######  ##
##      ##          ##      ##      ##
##  ##############  ##  ######  ######
##  ##              ##      ##      ##
##  ##  ##################  ######  ##
##      ##              ##  ##  ##  ##
##########  ##########  ##  ##  ##  ##
##          ##              ##      ##
##  ######  ##################  ######
##  ##      ##          ##          ##
##  ##########  ######  ##########  ##
##          ##  ##  ##      ##      ##
##  ######  ##  ##  ######  ##  ######
##  ##  ##      ##      ##  ##  ##  ##
##  ##  ##############  ##  ##  ##  ##
##  ##                  ##  ##  ##  ##
##  ##  ##############  ##  ##  ##  ##
##  ##  ##          ##  ##  ##      ##
##  ##  ##  ######  ##  ##  ##########
##  ##  ##  ##  ##      ##  ##        
##  ##  ##  ##  ##########  ##  ######
##      ##              ##          ##
######################################
