##########  ##########################
##          ##          ##          ##
##  ##############  ##  ##########  ##
##                  ##              ##
##################################  ##
##          ##              ##      ##
######  ##  ##########  ##  ##  ######
##      ##              ##  ##  ##  ##
##  ##################  ######  ##  ##
##              ##      ##      ##  ##
##############  ##  ######  ######  ##
##          ##  ##      ##  ##      ##
##  ######  ##  ##########  ##  ##  ##
##  ##          ##      ##      ##  ##
##  ##############  ##  ##########  ##
##      ##          ##          ##  ##
##  ##  ##  ##############  ######  ##
##  ##          ##          ##      ##
##  ##############  ##########  ######
##  ##              ##      ##  ##  ##
######  ######  ######  ##  ##  ##  ##
##      ##      ##      ##      ##  ##
##  ##########  ##  ##############  ##
##          ##  ##      ##            
##  ######  ##########  ##  ##  ######
##  ##  ##          ##  ##  ##      ##
##  ##  ##########  ##  ##########  ##
##          ##  ##  ##  ##      ##  ##
##########  ##  ##  ##  ##  ##  ##  ##
##              ##          ##      ##
######################################
